NO ./textures/Wall_N.xpm
SO ./textures/Wall_S.xpm
EA ./textures/Wall_E.xpm
WE ./textures/Wall_W.xpm

C 0,0,42
F 0,0,15

        1111111111111111111111111   11111
        100000000011000000000000111111111111111111111111111111111111111111111
        1011000001110000000N0000000000000000000000000000000000000000000000001   111
        100100000DD00000000000001111111111111111111111111111111111111111101011111B1
1111111110110000011100000000000011  11111                  100000000000000000000001
1000000000110000011101111111111101                       1110B000000000000001111111
11110111111111011100000010001  111                     111000BB00000000000011
11110111111111011101010000001      1111111111          100000000000000000001
11000000110101011100000010001      1000000001          10000000000000B000001
10000000000000001100000010001      1011111101          100000000000000000001
10000000000000001101010010001 1111 1000BBB101          100000000000000000001
1100010111010101111101111000111001111111111011111111111100000000000000000001
10000111 1110101 10111101000000000000000000000000000000000111111000111111111
10111111 1111111 111111111111111111111111111111111111111111    1DD11
1001                                                           1001
1011       111111111111111111111111111111111111111111111111111110011111111111111111111111111
1001       110000000000000000000000000000000000000000000000000000000000000000000000000000001
1011        11011111111110000000000000000000000000000000000000000000000000000000000000000001
1001111111   1DD1       10000000000000000000000000000000000000000000000000000000000000000001
1010001B11   1DD1       10000000000000000000000000000000000000000000000000000000000000000001
10101010111111DD11      10000000000000000000000000000000000000000000000000000000000000000001
10001000000000010111111110000000000000000000000000000000000000000000000000000000000000000001
11111111111111000000000000000000000000000000000000000000000000000000000000000000000000000001
             1111111111110000000000000000000000000000000000000000000000000000000000000000001
                        10000000000000000000000000000000000000000000000000000000000000000001
                        10000000000000000000000000000000000000000000000000000000000000000001
                        10000000000000000000000000000000000000000000000000000000000000000001
                        10000000000000000000000000000000000000000000000000000000000000000001
                        10101010101010101010101010101010101010101010101010101010101010101011
                        10000000000000000000000000000000000000000000000000000000000000000001
                        10000000000000000000000000000000000000000000000000000000000000000001
                        10101010101010101010101010101010101010101010101010101010101010101011
                        10000000000000000000000000000000000000000000000000000000000000000001
                        10000000000000000000000000000000000000000000000000000000000000000001
                        11101100110011001100110011001100110011001100110011001100110011001101
                        11101100110011001100110011001100110011001100110011001100110011001101
                        10000000000000000000000000000000000000000000000000000000000000000001
                        11111111111111111111111111111111111111111111111111111111111111111111

1111111  11   11  1111111  111111   11111
1111111  11   11  11   11  1111111  111111
11       11   11  11   11      11   11  111
11       11   11  111111      11    11   11
11       11   11  11   11      11   11   11
1111111  1111111  11   11  1111111  111111
1111111  1111111  1111111  111111   11111